7 6
1 1 1 1 0 0 
1 2 2 1 1 0
1 3 5 2 1 0
1 5 5 4 1 1
1 2 4 4 2 1
1 2 2 2 2 1
1 1 1 1 1 1