8 8
1 1 1 1 1 1 1 1
1 5 5 2 3 5 5 1
1 2 2 4 4 4 2 1
1 1 1 1 2 1 1 1
1 2 2 2 2 2 2 2
1 2 2 2 2 2 4 2
1 2 2 1 1 1 1 1
1 1 1 1 0 0 0 0
