10 7
0 0 1 1 1 1 0
0 1 1 2 2 1 0
1 2 2 2 2 1 0
1 2 2 2 2 1 0
1 1 1 4 4 1 0
0 0 1 5 5 1 0
0 0 1 5 5 1 0
0 1 3 5 5 2 1
0 1 2 2 2 2 1
0 1 1 1 1 1 1