9 8
1 1 1 1 1 1 1 1
1 2 2 2 2 2 2 1
1 3 4 2 4 4 2 1
1 1 1 1 2 2 1 0
1 2 2 1 1 2 2 1
1 2 2 1 5 2 5 1
1 2 2 2 5 2 2 1
0 1 2 2 2 2 1 0
0 0 1 1 1 1 0 0