9 8
0 0 0 0 1 1 1 0
0 0 0 1 2 2 1 0
0 0 1 2 2 2 1 0
0 1 2 1 5 4 1 1
1 2 2 5 5 3 2 1
1 2 2 4 4 6 2 1
1 1 1 1 2 2 2 1
0 0 0 1 2 2 1 0
0 0 0 1 1 1 1 0