11 8
0 0 1 1 1 1 1 1
0 1 1 2 2 2 2 2
1 1 2 2 2 2 4 2
1 2 4 2 1 1 1 1
1 2 4 4 3 4 2 1
1 2 2 2 2 2 2 2
1 1 1 1 1 2 2 2
1 5 2 1 2 1 2 2
1 5 2 5 1 1 2 2
1 2 2 2 2 2 2 2
0 1 5 2 5 2 2 1