11 8
0 0 1 1 1 1 0 0
0 1 2 5 5 2 1 0
1 5 3 6 4 2 2 1
1 2 2 1 2 2 2 1
1 2 2 1 1 1 1 1
1 5 2 4 2 2 1 0
1 2 2 4 2 2 2 1
1 5 1 1 1 2 2 1
1 2 4 2 4 2 2 1
0 1 2 2 2 2 1 0
0 0 1 1 1 1 0 0