7 8
0 0 1 1 1 1 0 0
0 0 1 2 2 1 1 1
1 1 1 2 5 2 2 1
1 3 4 4 4 2 2 1
1 2 2 2 1 5 2 1
1 1 1 5 2 2 1 1
0 0 1 1 1 1 1 0