8 8
0 1 1 1 1 0 0 0
0 1 2 2 1 0 0 0
0 1 2 2 1 1 1 1
0 1 2 5 5 6 2 1
1 1 2 4 4 3 2 1
1 2 2 2 1 1 1 1
1 2 2 2 1 0 0 0
1 1 1 1 1 0 0 0