8 8
1 1 1 1 1 0 0 0
1 2 2 2 1 1 1 0
1 2 2 5 4 2 1 1
1 1 2 5 1 2 4 2
0 1 2 5 1 2 4 3
0 1 1 5 2 2 4 2
0 0 1 2 2 1 1 1
0 0 1 1 1 1 0 0