7 8
1 1 1 1 0 0 0 0
1 2 2 1 1 1 1 1
1 2 2 2 2 3 2 1
1 2 5 6 5 4 6 2
1 1 2 2 1 4 2 2
0 1 1 2 2 2 1 1
0 0 1 1 1 1 1 0
