7 8
0 0 0 0 1 1 1 1
1 1 1 1 1 2 2 1
1 2 2 2 6 6 4 1
1 2 4 3 1 2 4 2 
1 1 4 5 5 2 2 2
0 1 2 2 1 1 2 2
0 1 1 1 1 1 1 1