8 7
0 1 1 1 1 1 0
0 1 2 2 2 1 0
0 1 2 1 4 1 1
1 1 5 5 3 2 1
1 2 6 5 4 2 1
1 2 1 2 4 1 1
1 2 2 2 2 1 0
1 1 1 1 1 1 0