8 8
1 1 1 0 0 0 0 0
1 5 1 1 1 1 1 0
1 5 5 5 2 2 1 0
1 2 1 2 1 2 1 1
1 2 2 2 5 5 2 3
1 1 1 2 2 5 5 2
0 0 1 1 1 2 2 2
0 0 0 0 1 1 1 1