7 8
0 1 1 1 1 1 1 1
0 1 2 2 1 1 2 5
1 1 2 2 2 4 2 2
1 2 2 4 2 4 2 5
1 2 2 2 1 3 2 1
1 5 2 1 1 2 2 1
1 1 1 1 1 1 1 1